
W: 29
H: 27
Map:
0  0  0  0  0  0  0  0  0  0  0  0  0  0  -1 -1 -1 -1 -1 -1 -1 -1 -1 -1 -1 -1 -1 -1 -1 
0  0  0  0  0  0  0  0  0  0  0  0  0  0  -1 -1 -1 -1 -1 -1 -1 -1 -1 -1 -1 -1 -1 -1 -1 
0  0  0  0  0  0  0  0  0  0  0  0  0  0  -1 -1 -1 -1 -1 -1 -1 -1 -1 -1 -1 -1 -1 -1 -1 
0  0  0  0  0  0  0  0  0  0  0  0  0  0  0  0  0  0  0  0  0  0  0  0  0  -1 -1 -1 0  
0  0  0  0  0  0  0  0  0  0  0  0  0  0  0  0  0  0  0  0  0  0  0  0  0  -1 -1 -1 0  
0  0  0  0  0  0  0  0  0  0  0  0  0  0  0  0  0  0  0  0  0  0  0  0  0  -1 -1 -1 0  
0  0  0  0  0  0  0  0  0  0  0  0  0  0  0  0  0  0  0  0  0  0  0  0  0  -1 -1 -1 0  
0  0  0  0  0  0  0  0  0  0  0  0  0  0  0  0  0  0  0  0  0  0  0  0  0  -1 -1 -1 0  
-1 -1 -1 -1 -1 -1 -1 -1 -1 -1 -1 -1 -1 -1 -1 -1 -1 -1 -1 -1 -1 -1 -1 0  -1 -1 -1 -1 0  
-1 -1 -1 -1 -1 -1 -1 -1 -1 -1 -1 -1 -1 -1 -1 -1 -1 -1 -1 -1 -1 -1 -1 0  -1 -1 -1 -1 0  
-1 -1 -1 -1 -1 -1 -1 -1 -1 -1 -1 -1 -1 -1 -1 -1 -1 -1 -1 -1 -1 -1 -1 0  -1 -1 -1 -1  0  
-1 -1 -1 -1 -1 -1 -1 -1 -1 -1 -1 -1 -1 -1 -1 -1 -1 -1 -1 -1 -1 -1 -1 0  -1 -1 -1 0  -1 
0  -1 -1 -1 -1 -1 -1 -1 -1 -1 -1 -1 -1 -1 -1 -1 -1 -1 -1 -1 -1 -1 -1 -1 -1 -1 -1 0  -1 
0  -1 -1 -1 -1 -1 -1 -1 -1 -1 -1 -1 -1 -1 -1 -1 -1 -1 -1 -1 -1 -1 -1 -1 -1 -1 -1 0  -1 
0  -1 -1 -1 -1 -1 -1 -1 -1 -1 -1 -1 -1 -1 -1 -1 -1 -1 -1 -1 -1 -1 -1 -1 0  0  0  0  -1 
0  -1 -1 -1 -1 -1 -1 -1 -1 -1 -1 -1 -1 -1 -1 -1 -1 -1 -1 0  0  0  -1 -1 0  -1 -1 -1 -1 
0  -1 -1 -1 -1 -1 -1 -1 -1 -1 -1 -1 -1 -1 -1 -1 -1 -1 -1 -1 -1 0   0 -1 0  -1 -1 -1 -1 
0  -1 -1 -1 -1  0  0  0 -1 -1 0  -1 -1 -1 -1 -1 -1 -1 -1 -1 -1 -1 -1 -1 0  0  0  0  0  
0  -1 -1 -1 -1 -1 -1 -1 -1 -1 0  -1 -1 -1 -1 -1 -1 -1 -1 -1 -1 -1 -1 -1 0  0  0  0  0  
0  -1 -1 -1 -1 -1 -1  0 -1 -1 0   0 -1 0  0  0  0  0  0  0  0  0  0  0  0  0  0  0  0  
0  0  -1 -1 -1 -1 -1 -1 -1 -1 -1 -1 -1 0  0  0  0  0  0  0  0  0  0  0  0  0  0  0  0  
0  0  0  0  -1 -1 -1 -1 -1 -1 -1 -1 -1 0  0  0  0  0  0  0  0  0  0  0  0  0  0  0  0  
0  0  0  0  0  0  0  0  0  0  0  0  0  0  0  0  0  0  0  0  0  0  0  0  0  0  0  0  0  
0  0  0  0  0  0  0  0  0  0  0  0  0  0  0  0  0  0  0  0  0  0  0  0  0  0  0  0  0  
0  0  0  0  0  0  0  0  0  0  0  0  0  0  0  0  0  0  0  0  0  0  0  0  0  0  0  0  0  
0  0  0  0  0  0  0  0  0  0  0  0  0  0  0  0  0  0  0  0  0  0  0  0  0  0  0  0  0  
0  0  0  0  0  0  0  0  0  0  0  0  0  0  0  0  0  0  0  0  0  0  0  0  0  0  0  0  0  
